11111111111111111111111
10000000000000000000001
1000110011001111110E001
100011C0110C11111100001
10001111110000011100001
1000111111000011100P001
10000000110001110000001
100C0000110011111100001
10000000110011111100001
10000000000000000000001
11111111111111111111111