111111111111
1P0000001EC1
1C0000000111
100000000001
111111111111